11111111111
100000000E1
10001000111
1C0P1001001
10001001001
10001111001
11111111111