111111111
100000C01
1000100E1
1C0P10001
10001C001
10C011101
111111111