11111
10001
10E01
10C01
10P01
10001
11111