1111111111111111
10C0000000000C01
100000P000000001
1000000000E00001
100C000000000001
100000000C000001
1111111111111111